111111111111111111111111
1E000000X0000X0C00000C01
10100101001000001010X101
1010010110101010001XX101
1P00X0000C00C000E00XX001
111111111111111111111111