111111111111111111111111
1E000000C000000C000000C1
101001010010000010100101
101001011010101000100101
1P0000000C00C000E0000001
111111111111111111111111





