11111111111111111
1100000C111100H01
10000000000000001