111111111111111111111111
1E0000000000X00C000X0C01
101001010010000010100101
101001011010101000100101
1P00X00X0C00C000E0000001
111111111111111111111111





