11111111111111111
100100C0000000011
1000011111E000001
10001100000011111
100C0000000001011
1111110000C000001
11110000000000011
10000011000000111
11000011000011111
1110001100P000001
11111111111111111

