111111111111111111111111
1E00000X0000000C00000C01
101001010010000010100101
1010010X1010101000100101
1P0000000C00C000E00X0001
111111111111111111111111





