11111111111111111
101000C0000000011
1000011111E000001
10111110000011111
10110110000001011
1C11111000C000001
10110110000P00011
10110111000000111
10110111000011111
1000011100C000001
11111111111111111

