111111
1X0E01
1PC001
100001
111111