111111
1X0E01
1PC001
111111
111111