111111
100E01
1PC001
100001
111111